111111111
1001000C1
1001110C1
1P01E0001
111111111