111111111
1001000C1
100111001
1P01E0001
111111111