111111111111111111111
1P0000000000000000001
10C0C0CCC0C00C000C001
10CCC0CC00C00C00C0C01
10C0C0CCC0CC0CC00C001
100000000000000000001
1000000000000000E0001
111111111111111111111