1111111111111
1P00000000001
10C000C0C0C01
10C000C0CCC01
10CCC0C0C0C01
10000000000E1
1111111111111