1111111
1P0C001
100EC01
1C000C1
1111111