1111111111
1C00P10EC1
1111010111
1C110101C1
1C00000001
1111111111