11111111111111111
1000C000C0C000001
1P00000CEC0000001
10000000C00000001
11111111111111111