GDSFGSDGFDSG
GSFDGSDGSDGD
GDFSGSGFDSGD
GSDGDSGSDGGD
gsdGSDFGDSGG