11111111111111111111111111111
10000000000000000000010000111
10000000000000C0000010100E0C1
10000000000000000000010000011
1P111111111111111110000011111
10000000000000000000010000001
10000000000000000000010000001
10000000000000000000010000001
10000000000000000000010000001
10000000000000000000010000001
10000000000000000000010000001
10000000000000000000010000001
10000000000000000000010000001
10000000000000000000010000001
11111111111111111111111111111
